12 11
************
*#---------*
---*********
*--*-*-*-*--
****-*-***--
*--***-*-*--
*--*-*-*-*--
*-**-***-*--
*-*---*--*--
*-*-*****$--
*****----***
