12 32
#*******************************
*------------------------------*
*------------------------------*
*------------------------------*
*------------------------------*
*---------------$--------------*
*------------------------------*
*------------------------------*
*------------------------------*
*------------------------------*
*------------------------------*
********************************
