10 10
$*----*--*
-****-****
----*-*--*
-****-**--
-*****-***
--**-#-*-*
*---****-*
***-*--*--
--***--**-
--*-*---*-
