45 63
***-*-*********-*-*-*-*******-***-*****-*********-*******-*-**#
*---*---*-*---*-*-*-*-*-*-*-*-*-*-*-*-*-*-----*-*-*-*-*-*-*---*
*-*-*****-***-*-*******-*-*-***-***-*-*-***-*-*-*-*-*-*-*******
*-*-*-*-*-*-*-*-*-*---*---*-*---*-*---*-*-*-*-*-*-*---*-*-*---*
*****-*-*-*-*-*-*-*-*-*-*-*-***-*-*-*-***-***-*-*****-*-*-***-*
--*-----------*-----*---*-------*-*-*-------*-----*---*-----*-*
*-***-***-*-*******-*****-*******-*-***-***-*-***-*-*-*****-*-*
*-*-----*-*-----*-*-*---------------*-*-*-*---*-*---*-*--------
*-***-*********-*-***-*-*******-*****-*-*-*****-***-*-*-*-*-*-*
*-*-*-*-*-*-*-*-*-*-*-*-*---*-*---*-*-----*-----*-*-*-*-*-*-*-*
*-*-***-*-*-*-*-*-*-*******-*-*-*-*-*********-***-*******-*-*-*
*-------------------------*-----*---------*-*-*---------*-*-*-*
*-*********-*-*******-*-*-*****-*-***-*-***-*-***-*-*-*********
*-*-*-*-*-*-*---*-*-*-*-*-*-*-*-*---*-*-*-*---*---*-*-*-------*
*-*-*-*-*-***-***-*-*****-*-*-*-*-***-*-*-***-*-*****-***-*****
*---*-----*-*-------*---*-*-----*-*-*-*---*-*-*-----*-*---*-*-*
*-*****-*-*-***-*****-*****-*-*-***-*-*****-*-*****-*-***-*-*-*
*-*-*---*---*-*-----*-------*-*-*---*-*-------*-*-*-*-*-*-*-*--
*-*-***-*****-***-*-*-*-*-*******-***-*-***-***-*-***-*-*-*-***
*---*---*-----*-*-*-*-*-*-*-*-----*-*-*-*-*-----------*--------
*-***-*******-*-***-*-*****-*-*****-*-*-*-*-*-*-*-*********-***
*-*-*---*-----------*-*-*-*-*-*---*-*-*-*-*-*-*-*---*-*-*-*-*-*
***-*-***************-*-*-*-*-***-*-*****-*********-*-*-*-*-*-*
*-*-*-*-*-*-*-*-*-*-*-*---*-*-*-*-*-----*-*-*---*-*-*---*-*-*-*
*-*-*-*-*-*-*-*-*-*-*-*-*-*-*-*-*-*-*-***-*-***-*-*-***-*-***-*
*-*-*-*-*-*-*-*-*-*-*---*-----------*-*---------------*--------
*-*-*-*-*-*-*-*-*-*-*-***********-*-***-*-*-*-***-***-*-*-***-*
------*-*---------*---------*-*-*-*-*-*-*-*-*-*---*-*-*-*-*---*
*****-*-***-*-*****-*********-*-*****-*-*-*-*-*-*-*-*-*-*-*****
*---*---*---*-----*-*---*-----*---------*-*-*-*-*-*---*-*---*-*
*-*-*****-*******-*-*-*-*****-*-*-*-*-*-*-*-***-***-***-*-***-*
*-*-*-*-*-*---*---*-*-*-*-*-*---*-*-*-*-*-*-*-*-*-*-*---*-*----
***-*-*-*****-***-*-***-*-*-*-*-*-*-*********-***-*********-***
*---*-----*-*-*-----*-*-*-*---*-*-*-*-*-*-*-*-*-*-*-*-*-*-*-*-*
***-***-*-*-*-***-***-*-*-*****-*-*-*-*-*-*-*-*-*-*-*-*-*-***-*
--*---*-*-----*---*-----*-*-*---*-*---------------*---*---*-*--
*-*-*-*-*-*******-*-*****-*-*-*-*****-*-*********-*-***-*-*-*-*
*---*---*-*---------*---*-----*-*-*-*-*-*-------*-*---*-*-*---*
*-*-*-*-***-***-*-*-*-***-***-***-*-*****-*-*****-***-***-***-*
*-*-*-*---*-*---*-*---*-*-*---*-----------*-*---*-*---*-*-*---*
*****-***-*-*-*-*-***-*-*****-***-*-***-*-*****-*-*-***-*-*-***
*-*-*-*-*-*-*-*-*-*-*-------------*-*---*-*-----*---------*-*-*
*-*-*-*-*****-*-*-*-*-*-*******-*********-*-*-*-***-*-*-*-***-*
*-------*-----*-*-*-*-*-*-*-*---*-*-----*-*-*-*-*-*-*-*-*-*-*-*
$******************-*****-*-*****-*****-*******-*-*********-*-*
