39 59
********$**************************************************
***********************************************************
***********************************************************
***********************************************************
***********************************************************
***********************************************************
*-*-*-*-*-*-***-***-*-*-*-*-*****-***-*******-*******-***-*
*-*-*-*-*-*-*-*-*-*-*-*-*-*-*-----*-*---*-*-*-*-*-*---*-*-*
*-*-*-*-*-***-*-*-*-*-*-*-*-*-*****-***-*-*-*-*-*-*-*-*-*-*
*---*-----*-*-*-*-*-*-*-*---*---*-*-*-*-----*-*-*-*-*-*-*-*
***-***-***-*-*-*-*-***-*-*-*-***-*-*-*****-*-*-*-***-*-***
--*-*-*-*-*-*-*-*-*-*-*-*-*-*-------*-------*-*-*-*-*---*-*
***-*-*-*-*-*-*-*-*-*-*-***-*********-***-***-*-*-*-***-*-*
--*-------*-*-*-*---------*-*-*---*-*-*-*-*-----*---*-----*
*-*-*-*****-*-*-*****-***-*-*-***-*-***-*-*-*******-*****-*
*-*-*-*-*-*-*-*-*---*-*-*-*-*-*-*-*-*-*-*-*-*---*-*-*-*-*-*
*****-*-*-*-*-*-***-*-*-*-*-*-*-*-*-*-*-*-*-*-***-*-*-*-*-*
*-*-*-*-*-*-*-*-*-*-*---*-*-*-*---*-*-*---*-*-*---*---*-*--
*-*-*-*-*-*-*-*-*-*-*****-*-*-*-***-*-*-***-*-*-*-***-*-***
--*-*-----*-------*---*---*-*-*---*-*---*-------*---*---*-*
*-*-*-*****-*******-*-*-*-*-*-*-*-*-***-***-*******-***-*-*
*-------*-*-*---*-*-*---*-------*-*-*-----*-*-*-*-*-*-*---*
*-*-*-***-*-*-*-*-*****-*****-***-*-*-*******-*-*-*-*-***-*
*-*-*-------*-*-*---*---*-----*---*---*-*-*---*-----*-*-*--
*********-***-*-***-*-*-*-*-*-*****-***-*-***-*-*****-*-*-*
*-*-*-*-------*-------*-*-*-*-----*-----*-*-*---*-*-*-*-*-*
*-*-*-*-***-*-*-*-*-*****-*****-*******-*-*-***-*-*-*-*-***
*-----*-*---*-*-*-*-*-*-*-*---*---*-*-*-*-*-*-*-*-*-*-*-*-*
*****-***-*-***-***-*-*-*****-***-*-*-*-*-*-*-*-*-*-*-*-*-*
*-*-------*-*-*---*---------*-------*-*---*-----*---*-*---*
*-*-*-*-***-*-*-***********-*-*-***-*-***-*-*-***-***-***-*
--*-*-*---*-*---*-*-*-------*-*-*-*-*-*-*-*-*-------*-*-*--
*****-*******-*-*-*-*-***-*-*****-*-*-*-*-***-***-*-*-*-***
--*---*-*-*-*-*---*-*-*---*---*-*-----*-*-*-*---*-*---*---*
*-*-*-*-*-*-***-***-***-*-***-*-*-*-***-*-*-*******-***-*-*
*-*-*---*-*-*-----*-*-*-*---*-*-*-*-*---*-*-----*-*-*-*-*--
*******-*-*-*-*****-*-*-***-*-*-*****-***-***-***-*-*-*****
*-*---*-*-*-*---*-*-*-*-*-*-*---*-------*---*---------*-*--
*-***-***-*-*****-*-*-***-************#-***-*********-*-***
