31 63
*-*-*-*-*-*-*-***-*****-*-*-***-*******-*-*****-***-*-*-*-***-*
*-*-*-*-*-*-*-*-*-*-*-*-*-*-*-*-*-*-*-*-*---*-*-*---*-*-*-*-*-*
*****-*-*******-***-*-*-***-*-*-*-*-*-***-*-*-*-***-*-*-***-*-*
*-*-*-*---*-*-*---*---*-*-*-*---*---*-*---*-*---*-*-*-*-----*-*
*-*-***-*-*-*-*-*****-*-*-***-***-*-*-*-***-*****-*****-*-*****
--*-*---*-------------*-----*---*-*-*---*-*---*-*-*-*---*-*-*-*
***-*************-*-***-*-***-*-***-*-*-*-*-***-*-*-*-*-***-*-*
*-------*-------*-*-*-*-*-*---*---*---*-*---*-*-*-*-*-*---*----
***-***-*-*-*-*****-*-***-***-***-*-***-*****-*-*-*-***-*-*-*-*
*-*-*-*-*-*-*-*-*-----*---*-*---*-*-*-*-*-----*---*-*-*-*-*-*-*
*-***-*-*****-*-*-*-*-*-***-*-*******-***-*-*-***-*-*-*-***-***
--*-*-*-*-*-*-*-*-*-*-*-*-------*-*-*-----*-*-*---*-*-*---*---*
#**-*-*-*-*-*-*-***-*******-*****-*-*****-*-***-*-*-*-*******-$
*-------*---*-*-*-*-*---*---*-----------*-*-----*-------*-----*
*-*-***-*-***-*-*-*-***-*-***-*-*-*************-*******-***-***
--*---*---*---*-*-*-*-*-*-----*-*---*---*-------*-*-*-*---*-*--
*-*******-*-*-*-*-***-*-*-*-*****-*****-*-***-***-*-*-*-***-*-*
*---*-*-*-*-*-*-*---*-----*-*-*-*-*-------*-*-*-*-*-*-*---*-*-*
***-*-*-***-*-*-*-*-*****-*-*-*-*-***-*-***-***-*-*-*-*****-***
*-*---------*-*-*-*-----*-*-*-*-*-*---*-*-*-*-*-*-*-*---*-*-*--
*-*-*******-***-*-***-***-*-*-*-***-*-***-*-*-*-*-*-***-*-*-*-*
*-----*-*-*-*-*-*---*-*---*-*-*---*-*-*-*-*-*-*---*-*-*---*-*-*
***-***-*-***-*-***-*-*-*-*-*-*-*****-*-*-*-*-***-*-*-*-*******
*-*---*-------*---*-*---*-*-----*-----------*---*-----*---*----
*-***-***-*******-*-*-***************-*-*****-*****-***-*****-*
*-*-------*---*---*-*-----*-------*-*-*---------*---*---------*
*-*-*-*******-*-***************-*-*-***********-***-*****-***-*
*---*-*---------*-*---*---*-*---*-*-*---*-----*-*---*-----*---*
*-***-*-*-***-***-*-*-*-***-***-*-*-***-*-***-*-*-*-*-*-*******
*-*-*-*-*-*-*-*-----*-*-*-*---*-*-*-*---*---*---*-*---*-*-*-*-*
***-*******-*-*******-*-*-***-***-*-***-*******-*********-*-*-*
