7 63
$-***-*-*****-*-***-*-*******-***-*-***-***-*-*******-***-***-*
*-*-*-*-*-----*-*-*-*-*-----*-*---*-*-----*-*---*-----*-*-*---*
*-*-*-*-*******-*-*****-*-***-*-*-*-*****-*-***-***-*-*-***-*-*
*-*---*-*---*---*-----*-*-*-*-*-*-*-*---*-*-*-*-*-*-*-*-*-*-*-#
*-*****-***-*****-*-*-*-*-*-*-*-*-*-*-*******-*-*-***-*-*-*-*-*
*-*-*-*-*-*---*-*-*-*-*-*-----*-*-*-----*---*-----*-*-*-*-*-*-*
***-*-***-***-*-*****-*********************-*******-***-*-*****
