31 15
#-***-***-*****
*-*-*-*---*-*-*
***-***-***-*-*
--*-*-*-*------
***-*-*-*-***-*
*-*---*-*---*-*
*-***-*******-*
----*---*-*-*-*
***-***-*-*-***
*---*---*------
*****-*******-*
----*-----*---*
***-***-*-*****
*-*-*-*-*-*---*
*-*-*-*-*-*-*-*
--*-*-*-*-*-*-*
***-*-***-*-*-*
*-*---*---*-*-*
*-***-***-*-***
--*---*---*-*-*
***-*-***-*-*-*
*---*-----*-*--
***-*******-*-*
*-*---*-----*-*
*-*-***-*****-*
*-------*-----*
*******-*****-*
*-----*-*-*-*-*
*-*-*****-*-***
*-*---*-*---*--
*****-*-***-**$
